64 64
4
8
10
28 37
 0; 0; 0; 0; 0; 0; 0; 0; 0; 0; 0; 0; 0; 0; 0; 0; 0; 0; 0; 0; 0; 0; 0; 0; 0; 0; 0; 0; 0; 0; 0; 0; 0; 0; 0; 0; 0; 0; 0; 0; 0; 0; 0; 0; 0; 0; 0; 0; 0; 0; 0; 0; 0; 0; 0; 0; 0; 0; 0; 0; 0; 0; 0; 0
 0; 0; 0; 0; 0; 0; 0; 0; 0; 0; 0; 0; 0; 0; 0; 0; 0; 0; 0; 0; 0; 0; 0; 0; 0; 0; 0; 0; 0; 0; 0; 0; 0; 0; 0; 0; 0; 0; 0; 0; 0; 0; 0; 0; 0; 0; 0; 0; 0; 0; 0; 0; 0; 0; 0; 3; 0; 0; 0; 0; 0; 0; 0; 0
 0; 0; 0; 0; 0; 0; 0; 0; 0; 0; 0; 0; 1; 1; 0; 0; 0; 0; 0; 0; 0; 0; 0; 0; 0; 0; 0; 0; 0; 0; 0; 0; 0; 0; 0; 0; 0; 0; 0; 0; 0; 0; 0; 0; 0; 0; 0; 0; 0; 0; 0; 0; 3; 3; 3; 3; 0; 0; 0; 0; 0; 0; 0; 0
 0; 0; 0; 0; 0; 0; 0; 0; 0; 0; 0; 0; 1; 1; 1; 1; 0; 0; 0; 0; 0; 0; 2; 2; 0; 0; 0; 0; 0; 0; 0; 0; 0; 0; 0; 0; 0; 0; 0; 0; 0; 3; 3; 0; 0; 0; 0; 0; 3; 3; 3; 3; 3; 3; 3; 3; 0; 0; 0; 0; 0; 0; 0; 0
 0; 0; 0; 0; 0; 0; 1; 0; 0; 0; 0; 1; 1; 1; 1; 1; 1; 0; 0; 0; 0; 0; 2; 2; 0; 0; 0; 0; 0; 0; 0; 0; 0; 0; 0; 0; 0; 0; 0; 0; 3; 3; 3; 0; 0; 0; 0; 0; 3; 3; 3; 3; 3; 3; 3; 3; 3; 0; 0; 0; 0; 0; 0; 0
 0; 0; 0; 0; 0; 1; 1; 1; 1; 1; 1; 1; 1; 1; 1; 1; 1; 1; 1; 1; 1; 1; 2; 2; 2; 2; 2; 2; 2; 0; 0; 0; 2; 2; 2; 2; 2; 2; 2; 2; 3; 3; 3; 3; 3; 3; 3; 3; 3; 3; 3; 3; 3; 3; 3; 3; 3; 3; 3; 0; 0; 0; 0; 0
 0; 0; 0; 1; 1; 1; 1; 1; 1; 1; 1; 1; 1; 1; 1; 1; 1; 1; 1; 1; 1; 1; 2; 2; 2; 2; 2; 2; 2; 0; 0; 0; 2; 2; 2; 2; 2; 2; 2; 3; 3; 3; 3; 3; 3; 3; 3; 3; 3; 3; 3; 3; 3; 3; 3; 3; 3; 3; 3; 0; 0; 0; 0; 0
 0; 0; 1; 1; 1; 1; 1; 1; 1; 1; 1; 1; 1; 1; 1; 1; 1; 1; 1; 2; 2; 2; 2; 2; 2; 2; 2; 2; 2; 0; 0; 0; 2; 2; 2; 2; 2; 2; 3; 3; 3; 3; 3; 3; 3; 3; 3; 3; 3; 3; 3; 3; 3; 3; 3; 3; 3; 3; 3; 3; 0; 0; 0; 0
 0; 0; 1; 1; 1; 1; 1; 1; 1; 1; 1; 1; 1; 1; 1; 1; 1; 1; 2; 2; 2; 2; 2; 2; 2; 2; 2; 2; 2; 2; 0; 2; 2; 2; 2; 2; 2; 2; 3; 3; 3; 3; 3; 3; 3; 3; 3; 3; 3; 3; 3; 3; 3; 3; 3; 3; 3; 3; 3; 3; 0; 0; 0; 0
 0; 0; 1; 1; 1; 1; 1; 1; 1; 1; 1; 1; 1; 1; 1; 1; 1; 1; 1; 2; 2; 2; 2; 2; 2; 2; 2; 2; 2; 2; 2; 2; 2; 2; 2; 2; 2; 3; 3; 3; 3; 3; 3; 3; 3; 3; 3; 3; 3; 3; 3; 3; 3; 3; 3; 3; 3; 3; 3; 3; 0; 0; 0; 0
 0; 0; 0; 1; 1; 1; 1; 1; 1; 1; 1; 1; 1; 1; 1; 1; 1; 1; 1; 1; 1; 1; 2; 2; 2; 2; 2; 2; 2; 2; 2; 2; 2; 2; 2; 2; 2; 3; 3; 3; 3; 3; 3; 3; 3; 3; 3; 3; 3; 3; 3;3P; 3; 3; 3; 3; 3; 3; 3; 3; 3; 0; 0; 0
 0; 0; 0; 0; 1; 1; 1; 1; 1; 1; 1; 1; 1; 1; 1; 1; 1; 1; 1; 1; 1; 1; 1; 2; 2; 2; 2; 2; 2; 2; 2; 2; 2; 2; 2; 2; 2; 3; 3; 3; 3; 3; 3; 3; 3; 3; 3; 3; 3; 3; 3; 3; 3; 3; 3; 3; 3; 3; 3; 3; 3; 0; 0; 0
 0; 0; 0; 0; 0; 1; 1; 1; 1; 1; 1; 1; 1; 1;1P; 1; 1; 1; 1; 1; 1; 1; 1; 2; 2; 2; 2; 2; 2; 2; 2; 2; 2; 2; 2; 2; 2; 3; 3; 3; 3; 3; 3; 3; 3; 3; 3; 3; 3; 3; 3; 3; 3; 3; 3; 3; 3; 3; 3; 3; 3; 0; 0; 0
 0; 0; 0; 0; 0; 1; 1; 1; 1; 1; 1; 1; 1; 1; 1; 1; 1; 1; 1; 1; 1; 1; 1; 2; 2; 2; 2; 2; 2; 2; 2; 2; 2; 2; 2; 2; 2; 3;3M;3M;3M;3M;3M; 3; 3; 3; 3; 3; 3; 3; 3; 3; 3; 3; 3; 3; 3; 3; 3; 3; 3; 0; 0; 0
 0; 0; 0; 0; 0; 0; 1; 1; 1; 1; 1; 1; 1; 1; 1; 1; 1; 1; 1; 1; 1; 1; 1; 2; 2; 2; 2; 2; 2; 2; 2; 2; 2; 2; 2; 2; 2; 2; 2; 3; 3; 3;3M; 3; 3; 3; 3; 3; 3; 3; 3; 3; 3; 3; 3; 3; 3; 3; 3; 3; 3; 0; 0; 0
 0; 0; 0; 0; 0; 0; 1; 1; 1; 1; 1; 1; 1; 1; 1; 1; 1; 1; 1; 1; 1; 1; 1; 2; 2; 2; 2; 2; 2; 2; 2;2P; 2; 2; 2; 2; 2; 2; 2; 2; 3; 3; 3; 3; 3; 3; 3; 3; 3; 3; 3; 3; 3; 3; 3; 3; 3; 3; 3; 3; 3; 0; 0; 0
 0; 0; 0; 0; 0; 0; 1; 1; 1; 1; 1; 1; 1; 1; 1; 1; 1; 1; 1; 1; 1; 1; 1; 2; 2; 2; 2; 2; 2; 2; 2; 2; 2; 2; 2; 2; 2; 2; 2; 2; 2; 3; 3; 3; 3;3M; 3; 3; 3; 3; 3; 3; 3; 3; 3; 3; 3; 3; 3; 3; 3; 0; 0; 0
 0; 0; 0; 0; 0; 1; 1; 1; 1; 1; 1; 1; 1; 1; 1; 1;1M; 1; 5; 5; 1; 1; 1; 5; 2; 2; 2; 2; 2; 2; 2; 2; 2; 2; 2; 2; 2; 2; 2; 2; 2; 2; 2; 3; 3; 3; 3; 3; 3; 3; 3; 3; 3; 3; 3; 3; 3; 3; 3; 0; 0; 0; 0; 0
 0; 0; 0; 0; 0; 1; 1; 1; 1; 4; 4; 1; 1; 1; 1; 1;1M; 1; 5; 5; 1; 5; 5; 5; 2; 2; 2; 2; 2; 2; 2; 2; 2; 2; 2; 2; 2; 2; 2; 2; 2; 2; 2; 3; 3; 3; 3; 3; 3; 3; 3; 3; 3; 3; 3; 3; 3; 3; 3; 0; 0; 0; 0; 0
 0; 0; 0; 0; 1; 1; 1; 1; 1; 4; 4; 1; 1; 1; 1; 1;1M; 1; 5; 5; 1; 5; 5; 5; 5; 2; 2; 2; 2; 2; 2; 2; 2; 2;2M; 2; 2; 2; 2; 2; 2; 2; 2; 3; 3; 3; 3; 3; 3; 6; 6; 3; 3; 3; 3; 3; 3; 3; 3; 0; 0; 0; 0; 0
 0; 0; 0; 0; 1; 1; 1; 4; 4; 4; 4; 4; 4; 1; 1; 1;1M; 1; 5; 5; 5; 5; 5; 5; 5; 2; 2; 2; 2; 2; 2; 2; 2; 2;2M;2M; 2; 2; 2; 5; 5; 2; 2; 3; 3; 3; 3; 3; 6; 6; 6; 6; 6; 3; 3; 3; 6; 6; 3; 0; 0; 0; 0; 0
 0; 0; 0; 0; 1; 1; 1; 4; 4; 4; 4; 4; 4; 4; 1; 1;1M;1M; 5; 5; 5; 5; 5; 5; 5; 2; 2; 2; 2; 2; 2; 2; 2; 2; 2;2M; 2; 2; 5; 5; 5; 2; 5; 5; 3; 3; 6; 6; 6; 6; 6; 6; 6; 3; 3; 3; 6; 6; 0; 0; 0; 0; 0; 0
 0; 0; 0; 0; 1; 1; 4; 4; 4; 4; 4; 4; 4; 4; 4; 1;1M;1M; 5; 5; 5; 5; 5; 5; 5; 5; 2; 2; 2; 2; 2; 2; 2; 2; 2;2M;2M; 5; 5; 5; 5; 5; 5; 5; 5; 5; 6; 6; 6; 6; 6; 6; 6; 6; 6; 6; 6; 6; 3; 0; 0; 0; 0; 0
 0; 0; 0; 4; 4; 4; 4; 4; 4; 4; 4; 4; 4; 4; 4; 4; 4; 4; 5; 5; 5; 5; 5; 5; 5; 5; 5; 5; 5; 2; 2; 2; 5; 5; 5;5M;5M;5M; 5; 5; 5; 5; 5; 5; 5; 5; 6; 6; 6; 6; 6; 6; 6; 6; 6; 6; 6; 6; 6; 6; 0; 0; 0; 0
 0; 0; 0; 4; 4; 4; 4; 4; 4; 4; 4; 4; 4; 4; 4; 4; 4; 4; 4; 4; 5; 5; 5; 5; 5; 5; 5; 5; 5; 2; 2; 5; 5; 5; 5; 5; 5; 5;5M; 5; 5; 5; 5; 5; 5; 6; 6; 6; 6; 6; 6; 6; 6; 6; 6; 6; 6; 6; 6; 6; 0; 0; 0; 0
 0; 0; 0; 4; 4; 4; 4; 4; 4; 4; 4; 4; 4; 4; 4; 4; 4; 4; 4; 4; 5; 5; 5; 5; 5; 5; 5; 5; 5; 5; 5; 5; 5; 5; 5; 5; 5; 5;5M; 5; 5; 5; 5; 5; 5; 6; 6; 6; 6;6M; 6; 6; 6; 6; 6; 6; 6; 6; 6; 6; 0; 0; 0; 0
 0; 0; 0; 4; 4; 4; 4; 4; 4; 4; 4; 4; 4; 4; 4; 4; 4; 4; 4; 4; 5; 5; 5; 5; 5; 5; 5; 5; 5; 5; 5; 5; 5; 5; 5; 5; 5; 5; 5; 5; 5; 5; 5; 5; 5; 6; 6; 6; 6;6M;6M; 6; 6; 6; 6; 6; 6; 6; 6; 6; 6; 0; 0; 0
 0; 0; 0; 4; 4; 4;4P; 4; 4; 4; 4; 4; 4; 4; 4; 4; 4; 4; 4; 4; 5; 5; 5; 5; 5; 5; 5; 5;5M; 5; 5; 5; 5; 5; 5; 5; 5; 5; 5; 5; 5; 5; 5; 5; 5; 6; 6; 6; 6;6M;6M; 6; 6; 6; 6; 6; 6; 6; 6; 6; 6; 0; 0; 0
 0; 0; 0; 4; 4; 4; 4; 4; 4; 4; 4; 4; 4; 4; 4; 4; 4; 4; 4; 4; 5; 5; 5; 5; 5; 5; 5; 5;5M; 5; 5; 5; 5; 5; 5; 5; 5; 5; 5; 5; 5; 5; 5; 5; 5; 6; 6; 6; 6;6M; 6; 6; 6; 6; 6; 6; 6; 6; 6; 6; 6; 0; 0; 0
 0; 0; 0; 4; 4; 4; 4; 4; 4; 4; 4; 4; 4; 4; 4; 4; 4; 4; 4; 4; 5; 5; 5; 5; 5; 5; 5; 5;5M;5M;5M; 5; 5; 5; 5; 5; 5; 5; 5; 5; 5; 5; 5; 5; 5; 6; 6; 6; 6;6M; 6; 6; 6; 6; 6; 6; 6; 6; 6; 6; 6; 0; 0; 0
 0; 0; 0; 4; 4; 4; 4; 4; 4; 4; 4; 4; 4; 4; 4; 4; 4; 4; 4; 4; 5; 5; 5; 5; 5; 5; 5; 5;5M; 5; 5; 5; 5; 5; 5; 5; 5; 5; 5; 5; 5; 5; 5; 5; 5;5P; 6; 5; 6;6M; 6; 6; 6; 6; 6; 6; 6; 6; 6; 0; 0; 0; 0; 0
 0; 0; 0; 4; 4; 4; 4; 4; 4; 4; 4; 4; 4; 4; 4; 4; 4; 4; 4; 4; 5; 5; 5; 5; 5; 5; 5; 5;5M; 5; 5; 5; 5; 5; 5; 5; 5; 5; 5; 5; 5; 5; 5; 5; 5; 5; 5; 5; 6;6M; 6; 6; 6; 6; 6;6P; 6; 6; 6; 0; 0; 0; 0; 0
 0; 0; 0; 4; 4; 4; 4; 4; 4; 4; 4; 4; 4; 4; 4; 4; 4; 4; 4; 4; 5; 5; 5; 5; 5; 5; 5; 5;5M; 5; 5; 5; 5; 5; 5; 5; 5; 5; 5; 5; 5; 5; 5; 5; 5; 5; 5; 5; 6;6M; 6; 6; 6; 6; 6; 6; 6; 6; 6; 0; 0; 0; 0; 0
 0; 0; 0; 4; 4; 4; 4; 4; 4; 4; 4; 4; 4; 4; 4; 4; 4; 4; 4; 4; 5; 5; 5; 5; 5; 5; 5; 5;5M;5M;5M; 5; 5; 5; 5; 5; 5; 5; 5; 5; 5; 5; 5; 5; 5; 5; 5; 5; 6;6M; 6; 6; 6; 6; 6; 6; 6; 6; 6; 6; 6; 6; 0; 0
 0; 0; 0; 4; 4; 4; 4; 4; 4; 4; 4; 4; 4; 4; 4; 4; 4; 4; 4; 4; 5; 5; 5; 5; 5; 5; 5; 5;5M; 5;5M; 5; 5; 5; 5; 5; 5; 5; 5; 5; 5; 5; 5; 5; 5; 5; 5; 5; 6; 6; 6; 6; 6; 6; 6; 6; 6; 6; 6; 6; 6; 6; 0; 0
 0; 0; 0; 4; 4; 4; 4; 4; 4; 4; 4; 4; 4; 4; 4; 4; 4; 4; 4; 4; 5; 5; 5; 5; 5; 5; 5; 5; 5; 5; 5; 5; 5; 5; 5; 5; 5; 5; 5; 5; 5; 5; 5; 5; 5; 5; 5; 5; 6; 6; 6; 6; 6; 6; 6; 6; 6; 6; 6; 6; 6; 6; 0; 0
 0; 0; 0; 4; 4; 4; 4; 4; 4; 4; 4; 4; 4; 4; 4; 7; 7; 4; 4; 4; 5; 5; 5; 5; 5; 5; 5; 5; 5; 5; 5; 5; 5; 5; 8; 5; 5; 5; 5; 5; 5; 5; 5; 5; 5; 5; 5; 5; 6; 6; 6; 6; 6; 6; 6; 6; 6; 6; 6; 6; 6; 6; 0; 0
 0; 0; 0; 4; 4; 4; 4; 4; 4; 4; 4; 4; 4; 4; 7; 7; 7; 4; 4;5M; 5; 5; 5; 5; 5; 5; 5; 5; 5; 5; 5; 8; 8; 8; 8; 5; 5; 5; 5; 5; 5; 5; 5; 5; 5; 5; 5; 6; 6; 6; 6; 6; 6; 6; 6; 6; 6; 6; 6; 6; 6; 6; 0; 0
 0; 0; 0; 4; 4; 4; 4; 4; 4; 4; 4; 4; 4; 7; 7; 7; 4; 4; 4;5M; 5; 5; 5; 5; 5; 5; 5; 5; 5; 5; 8; 8; 8; 8; 8; 8; 5; 5; 5; 5; 5;5M; 5; 5; 5; 5; 6; 6; 6; 6; 6; 6; 6; 6; 6; 6; 6; 6; 6; 6; 6; 6; 0; 0
 0; 0; 0; 4; 4; 4; 4; 4; 4; 4; 4; 4;4M;7M;7M;4M;4M;4M; 5; 5; 5; 5; 5; 5; 5; 5; 8; 8; 5; 5; 5;5P; 8; 8; 8; 8; 5; 5; 5;5M;5M;5M; 5; 5; 5; 6; 6; 6; 6; 6; 6; 6; 6; 6; 6; 9; 9; 6; 6; 6; 6; 6; 0; 0
 0; 0; 0; 0; 4; 4; 4; 4; 4; 4; 4; 4; 4; 7; 7; 4;4M; 4; 5; 5; 5; 5; 5; 5; 5; 5; 8; 8; 8; 5; 5; 8; 8; 8; 8; 8; 8; 5; 5;5M;5M;5M; 5; 5; 5; 6; 6; 9; 6; 6; 6; 6; 6; 6; 9; 9; 9; 6; 6; 6; 6; 6; 0; 0
 0; 0; 0; 0; 0; 0; 0; 7; 7; 7; 7; 7; 7; 7; 7; 7;7M; 7; 7; 7; 5; 5; 5; 5; 5; 5; 8; 8; 8; 8; 8; 8; 8; 8; 8; 8; 8; 8; 8; 8;8M;8M; 8; 8; 8; 8; 8; 9; 9; 9; 9; 9; 9; 9; 9; 9; 9; 0; 0; 0; 0; 0; 0; 0
 0; 0; 0; 0; 0; 0; 0; 7; 7; 7; 7; 7; 7; 7; 7; 7; 7; 7; 7; 7; 7; 7; 5; 5; 5; 7; 8; 8; 8; 8; 8; 8; 8; 8; 8; 8; 8; 8; 8; 8; 8; 8; 8; 8; 8; 8; 8; 9; 9; 9; 9; 9; 9; 9; 9; 9; 9; 0; 0; 0; 0; 0; 0; 0
 0; 0; 0; 0; 0; 0; 0; 7; 7; 7; 7; 7; 7; 7; 7; 7; 7; 7; 7; 7; 7; 7; 7; 7; 7; 7; 8; 8; 8; 8; 8; 8; 8; 8; 8; 8; 8; 8; 8; 8; 8; 8; 8; 8; 8; 8; 8; 9; 9; 9; 9; 9; 9; 9; 9; 9; 9; 0; 0; 0; 0; 0; 0; 0
 0; 0; 0; 0; 0; 0; 0; 7; 7; 7; 7; 7; 7; 7; 7; 7; 7; 7; 7; 7; 7; 7; 7; 7; 7; 7; 8; 8; 8; 8; 8; 8; 8; 8; 8; 8; 8; 8; 8; 8; 8; 8; 8; 8; 8; 8; 8; 9; 9; 9; 9; 9; 9; 9; 9; 9; 0; 0; 0; 0; 0; 0; 0; 0
 0; 0; 0; 0; 0; 0; 0; 7; 7; 7; 7; 7; 7; 7; 7;7P; 7; 7; 7; 7; 7; 7; 7; 7; 7; 8; 8; 8; 8; 8; 8; 8; 8; 8; 8; 8; 8; 8; 8; 8; 8; 8; 8; 8; 8; 8; 8; 9; 9; 9; 9; 9; 9; 9; 9; 9; 0; 0; 0; 0; 0; 0; 0; 0
 0; 0; 0; 0; 0; 0; 7; 7; 7; 7; 7; 7; 7; 7; 7; 7; 7; 7; 7; 7; 7; 7; 7; 7; 7; 8; 8; 8; 8; 8; 8; 8; 8; 8; 8; 8; 8; 8; 8; 8; 8; 8; 8; 8; 8; 8; 8; 9;9M; 9; 9; 9; 9; 9; 9; 9; 0; 0; 0; 0; 0; 0; 0; 0
 0; 0; 0; 0; 0; 0; 7; 7; 7; 7; 7; 7; 7; 7; 7; 7; 7; 7; 7; 7; 7; 7; 7; 7; 7; 8; 8; 8; 8; 8; 8; 8; 8; 8; 8;8M;8M; 8; 8; 8; 8; 8; 8; 8; 8; 8; 8;9M;9M;9M; 9; 9; 9; 9; 9; 9; 0; 0; 0; 0; 0; 0; 0; 0
 0; 0; 0; 0; 0; 0; 7; 7; 7; 7; 7; 7; 7; 7; 7; 7; 7; 7; 7; 7; 7; 7; 7; 7; 7; 8; 8; 8; 8; 8; 8; 8; 8;8M;8M;8M;8M;8M; 8; 8; 8; 8; 8; 8; 8; 8;8M;9M;9M;9M;9M; 9; 9; 9; 9; 9; 0; 0; 0; 0; 0; 0; 0; 0
 0; 0; 0; 0; 0; 7; 7; 7; 7; 7; 7; 7; 7; 7; 7; 7; 7; 7; 7; 7; 7; 7; 7; 8; 8; 8; 8; 8; 8; 8; 8; 8; 8; 8;8M;8M; 8; 8; 8; 8; 8; 8; 8; 8; 9; 9; 9; 9; 9;9M; 9; 9; 9; 9; 9; 9; 0; 0; 0; 0; 0; 0; 0; 0
 0; 0; 0; 0; 0; 0; 7; 7; 7; 7; 7; 7; 7; 7; 7; 7; 7; 7; 7; 7; 7; 7; 7; 8; 8; 8; 8; 8; 8; 8; 8; 8; 8; 8; 8; 8; 8; 8; 8; 8; 8; 8; 8; 9; 9; 9; 9; 9;9P; 9; 9; 9; 9; 9; 9; 9; 0; 0; 0; 0; 0; 0; 0; 0
 0; 0; 0; 0; 0; 0; 7; 7; 7; 7; 7; 7; 7; 7; 7; 7; 7; 7; 7; 7; 7; 7; 7; 8; 8; 8; 8; 8; 8; 8; 8; 8; 8; 8; 8;8P; 8; 8; 8; 8; 8; 8; 8; 8; 9; 9; 9; 9; 9; 9; 9; 9; 9; 9; 9; 9; 0; 0; 0; 0; 0; 0; 0; 0
 0; 0; 0; 0; 0; 0; 7; 7; 7; 7; 7; 7; 7; 7; 7; 7; 7; 7; 7; 7; 7; 7; 7; 8;7M; 8; 8;8M; 8; 8; 8; 8; 8; 8; 8; 8; 8; 8; 8; 8; 8; 8; 8; 8; 8; 8; 9; 9; 9; 9; 9; 9; 9; 9; 9; 9; 0; 0; 0; 0; 0; 0; 0; 0
 0; 0; 0; 0; 0; 7; 7; 7; 7; 7; 7; 7; 7; 7; 7; 7; 7; 7; 7; 7; 7; 7; 7;8M;7M;7M;8M;8M; 8; 8; 8; 8; 8; 8; 8; 8; 8; 8; 8; 8; 8; 8; 8; 8; 8; 8; 8; 9; 9; 9; 9; 9; 9; 9; 9; 9; 0; 0; 0; 0; 0; 0; 0; 0
 0; 0; 0; 0; 0; 7; 7; 7; 7; 7; 7; 7; 7; 7; 7; 7; 7; 7; 7; 7; 7; 7; 7; 7;7M; 7;8M;8M;8M; 8; 8; 8; 8; 8; 8; 8; 8; 8; 8; 8; 8; 8; 8; 8; 8; 8; 8; 9; 9; 9; 9; 9; 9; 9; 9; 9; 0; 0; 0; 0; 0; 0; 0; 0
 0; 0; 0; 0; 7; 7; 7; 7; 7; 7; 7; 7; 7; 7; 7; 7; 7; 7; 7; 7; 7; 7; 7; 7; 7; 7; 8; 8; 8; 8; 8; 8; 8; 8; 8; 8; 8; 8; 8; 8; 8; 8; 8; 8; 8; 8; 9; 9; 9; 9; 9; 9; 9; 9; 9; 9; 0; 0; 0; 0; 0; 0; 0; 0
 0; 0; 0; 7; 7; 7; 7; 7; 7; 7; 7; 7; 7; 7; 7; 7; 7; 7; 7; 7; 7; 7; 7; 7; 7; 7; 8; 8; 8; 8; 8; 8; 8; 8; 8; 8; 8; 8; 8; 8; 8; 8; 8; 8; 8; 8; 9; 9; 9; 9; 9; 9; 9; 9; 9; 9; 0; 0; 0; 0; 0; 0; 0; 0
 0; 0; 0; 7; 7; 7; 7; 7; 7; 7; 7; 7; 7; 7; 7; 7; 7; 7; 7; 7; 7; 7; 7; 7; 7; 7; 8; 8; 8; 8; 8; 8; 8; 8; 8; 8; 8; 8; 8; 8; 8; 8; 8; 8; 8; 8; 8; 9; 9; 9; 9; 9; 9; 9; 9; 9; 0; 0; 0; 0; 0; 0; 0; 0
 0; 0; 7; 7; 7; 7; 7; 7; 7; 7; 7; 7; 7; 7; 7; 7; 7; 7; 7; 7; 7; 7; 7; 7; 7; 8; 8; 8; 8; 8; 8; 8; 8; 8; 8; 8; 8; 8; 8; 8; 8; 8; 8; 8; 8; 8; 8; 8; 9; 9; 9; 9; 9; 9; 9; 9; 0; 0; 0; 0; 0; 0; 0; 0
 0; 0; 0; 0; 7; 7; 0; 0; 0; 0; 0; 7; 7; 7; 7; 7; 7; 7; 7; 0; 7; 0; 0; 0; 0; 8; 8; 8; 8; 8; 8; 8; 8; 8; 0; 0; 0; 0; 0; 0; 0; 0; 0; 0; 0; 8; 8; 8; 0; 0; 0; 0; 0; 0; 0; 0; 0; 0; 0; 0; 0; 0; 0; 0
 0; 0; 0; 0; 7; 7; 0; 0; 0; 0; 0; 0; 7; 7; 0; 7; 7; 7; 0; 0; 0; 0; 0; 0; 8; 8; 8; 8; 0; 0; 0; 8; 8; 0; 0; 0; 0; 0; 0; 0; 0; 0; 0; 0; 0; 0; 8; 0; 0; 0; 0; 0; 0; 0; 0; 0; 0; 0; 0; 0; 0; 0; 0; 0
 0; 0; 0; 0; 0; 0; 0; 0; 0; 0; 0; 0; 0; 0; 0; 0; 0; 0; 0; 0; 0; 0; 0; 0; 8; 8; 8; 0; 0; 0; 0; 0; 8; 0; 0; 0; 0; 0; 0; 0; 0; 0; 0; 0; 0; 0; 0; 0; 0; 0; 0; 0; 0; 0; 0; 0; 0; 0; 0; 0; 0; 0; 0; 0
 0; 0; 0; 0; 0; 0; 0; 0; 0; 0; 0; 0; 0; 0; 0; 0; 0; 0; 0; 0; 0; 0; 0; 0; 0; 0; 0; 0; 0; 0; 0; 0; 0; 0; 0; 0; 0; 0; 0; 0; 0; 0; 0; 0; 0; 0; 0; 0; 0; 0; 0; 0; 0; 0; 0; 0; 0; 0; 0; 0; 0; 0; 0; 0
 0; 0; 0; 0; 0; 0; 0; 0; 0; 0; 0; 0; 0; 0; 0; 0; 0; 0; 0; 0; 0; 0; 0; 0; 0; 0; 0; 0; 0; 0; 0; 0; 0; 0; 0; 0; 0; 0; 0; 0; 0; 0; 0; 0; 0; 0; 0; 0; 0; 0; 0; 0; 0; 0; 0; 0; 0; 0; 0; 0; 0; 0; 0; 0