68 68
6
12
10
49 16
0;0;0;0;0;0;0;0;0;0;0;0;0;0;0;0;0;0;0;0;0;0;0;0;0;0;0;0;0;0;0;0;0;0;0;0;0;0;0;0;0;0;0;0;0;0;0;0;0;0;0;0;0;0;0;0;0;0;0;0;0;0;0;0;0;0;0;0
0;0;0;0;0;0;0;0;0;0;0;0;0;0;0;0;0;0;0;0;0;0;0;0;0;0;1;1;1;0;0;0;0;5;5;5;5;5;5;5;5;5;5;5;5;5;5;5;5;5;5;5;5;5;5;5;5;5;5;5;5;5;5;5;5;5;5;0
0;0;0;0;0;0;0;6;0;0;0;0;0;0;0;0;0;0;0;0;0;0;0;0;0;1;1;1;1;1;0;0;0;5;5;5;5;5;5;5;5;5;5;5;5;5;5;5;5;5;5;5;5;5;5;5;5;5;5;5;5;5;5;5;5;5;5;0
0;0;0;0;0;0;6;6;6;0;0;0;0;0;0;0;0;0;0;0;0;0;0;0;1P;1;1;1;1;1;1;0;0;0;5;5;5;5;5;5;5;5;5;5;5;5;5;5;5;5;5;5M;5;5;5;5;5;5;5;5;5;5;5;5;5;5;5;0
0;0;0;0;0;6;6;6;6;6;0;0;0;0;0;0;0;0;0;0;0;0;0;1;1;1;1;1;1;1M;1;1;0;0;0;5;5;5;5;5;5;5;5;5;5;5;5;5;5;5;5;5;5;5;5;5;5;5;5;5;5;5;5;5;5;5;5;0
0;0;0;0;6;6;6;6;6;6;6;0;0;0;0;0;0;0;0;0;0;0;1;1;1;1;1;1;1;1;1;1;1;0;0;0;5;5;5;5;5;5;5;5;5;5;5;5;5;5;5;5;5;5;5;5;5;5;5;5;5;5;5;5;5;5;5;0
0;0;0;6;6;6;6;6;6;6;6;6;0;0;0;0;0;0;0;0;0;1;1;1;1;1;1;1;1;1;1;1;1;1;0;0;0;5;5;5;5;5;5;5;5;5;5;5;5;5;5;5;5;5;5;5;5;5;5;5;5;5;5;5;5;5;5;0
0;0;6;6;6;6;6;6;6;6;6;6;6;0;0;0;0;0;0;0;1;1;1;1;1;1;1;1;1;1;1;1;1;1;1;0;0;0;5;5;5;5;5;5;5;5;5;5;5;5;5;5;5;5;5;5;5;5;5;5;5;5;5;5;5P;5;5;0
0;0;6;6;6;6;6;6;6;6;6;6;6;0;0;0;0;0;0;1;1;1;1;1;1;1;1;1;1;1;1;1;1;1;1;1;0;0;0;5;5;5;5;5;5;5;5;5;5;5;5;5;5;5;5;5;5;5;5;5;5;5;5;5;5;5;5;0
0;6;6;6;6;6;6;6;6;6;6;6;6;6;0;0;0;0;1;1;1;1;1;1;1;1;1;1;1;1;1;1;1;1;1;1;1;0;0;0;5;5;5;5;5;5;5;5;5;5;5;5;5;5;5;5;5;5;5;5;5;5;5;5;5;5;5;0
0;6;6;6;6;6;6;6;6;6;6;6;6;6;6;0;0;1;1;1;1;1;1;1;1;1;1;1;1;1;1;1P;1;1;1;1;1;1;0;0;5;5;5;5;5;5;5;5;5;5;5;5;5;5;5;5;5;5;5;5;5;5;5;5;5;5;5;0
0;6;6;6;6;6;6;6;6;6;6;6;6;6;6;6;1;1;1;1;1;1;1;1;1;1;1;1;1;1;1;1;1;1;1;1;1;1;1;0;0;5;5;5;5;5;5;5;5;5;5;5;5;5;5;5;5;5;5;5;5;5;5;5;5;5;9;0
0;6;6;6;6;6;6;6;6;6;6;6;6;6;6;1;1;1;1;1;1;1;1;1;1;1;1;1;1;1;1;1;1;1;1;1;1;1;1;1;0;0;5;5;5;5;5;5;5;5;5;5;5;5;5;5;5;5;5;5;5;5;5;5;5;9;9;0
0;6;6;6;6;6;6;6;6;6;6;6;6;6;1;1;1;1;1;1;1;1;1;1;1;1;1;1;1;1;1;1;1;1;1;1;1;1;1;1;1;0;0;5;5;5;5;5;5;5;5;5;5;5;5;5;5;5;5;5;5;5;5;5;9;9;9;0
0;6;6;6;6;6;6;6;6;6;6;6;6;1;1;1;1;1;1;1;1;1;1;1;1;1;1;1;1;1;1;1M;1;1;1;1;1;1;1;1;1;1;0;0;5;5;5;5;5;5;5;5;5;5;5;5;5;5;5;5;5;5;5;9;9;9;9;0
0;6;6;6;6;6;6;6;6;6;6;6;6;1;1;1;1;1;1;1;1;1;1;1;1;1;1;1;1;1;1;1;1;1;1;1;1;1;1;1;1;1;0;0;0;5;5;5;5;5;5;5;5;5;5;5;5;5;5;5;5;5;9;9;9;9;9;0
0;6;6;6;6;6;6;6;6;6;6;6;6;6;1;1;1;1;1;1;1;1;1;1;1;1;1;1;1;1;1;1;1;1;1;1;1;1;1;1;1;0;0;0;0;0;5;5;5;5;5;5;5;5;5;5;5;5;5;5;5;9;9;9;9;9;9;0
0;6;6;6;6;6;6;6P;6;6;6;6;6;6;6;1;1;1;1;1;1;1;1;1;1;1;1;1;1;1;1;1;1;1;1;1;1;1;1;1;0;0;0;0;0;0;0;5;5;5;5;5;5;5;4;5;5;5;5;5;9;9;9;9;9;9;9;0
0;6;6;6;6;6;6;6;6;6;6;6;6;6;6;1;1;1;1;1;1;1;1;1;1;1;1;1;1;1;1;1;1;1;1;1;1;1;1;0;0;0;0;0;0;0;0;0;5;5;5;5;5;5;4;5;5;5;5;9;9;9;9;9;9;9;9;0
0;6;6;6;6;6;6;6;6;6;6;6;6;6;6;6;1;1;1;1;1;1;1;1;1;1;1;1;1;1;1;1;1;1;1;1;1;1;1;0;0;0;0;0;0;0;0;0;0;5;5;5;5;4;4;4;5;5;9;9;9;9;9;9;9;9;9;0
0;6;6;6;6;6;6;6;6;6;6;6;6;6;6;6;6;1;1;1;1;1;1;1P;1;1;1;1;1;1;1;1;1;1;1;1;1;1;0;0;0;0;0;0;0;0;0;0;0;0;5;5;4;4;4;4;4;9;9;9;9;9;9;9;9;9;9;0
0;6;6;6;6;6;6;6;6;6;6;6;6;6;6;6;6;6;1;1;1;1;1;1;1;1;1;1;1;1;1;1;1;1;1;1;1;0;0;0;0;0;0;0;0;0;0;0;0;0;0;4;4;4;4;4;4;4;9;9;9;9;9;9;9;9;9;0
0;6;6;6;6;6;6;6;6;6;6;6;6;6;6;6;6;6;6;1;1;1;1;1;1;1;1;1;1;1;1;1;1;1;1;1;0;0;0;0;0;0;0;0;0;0;0;0;0;0;4;4;4;4;4;4;4;4;4;9;9;9;9;9;9;9;9;0
0;6;6;6;6;6;6;6;6;6;6;6;6;6;6;6;6;6;6;6;1;1;1;1;1;1;1;1;1;1;1;1;1;1;1;0;0;0;0;0;0;0;0;0;0;0;0;0;0;4;4;4;4;4;4;4;4;4;4;4;9;9;9;9;9;9;9;0
0;6;6;6;6;6;6;6;6;6;6;6;6;6;6;6;6;6;6;6;6;1;1;1;1;1;1;1;1;1;1;1;1;1;0;0;0;0;0;0;0;0;0;0;0;0;0;0;4;4;4;4;4;4;4;4;4;4;4;4;4;9;9;9;9;9;9;0
0;6;6;6;6;6;6;6;6;6;6;6;6;6;6;6;6;6;6;6;6;6;1;1;1;1;1;1;1;1;1;1;1;0;0;0;0;0;0;0;0;0;0;0;0;0;0;4;4;4;4;4;4;4;4;4;4;4;4;4;4;4;9;9;9;9;9;0
0;6;6;6;6;6;6;6;6;6;6;6;6;6;6;6;6;6;6;6;6;0;0;1;1;1;1;1;1;1;1;1;0;0;0;0;0;0;0;0;0;0;0;0;0;0;4;4;4;4;4;4;4;4;4;4;4;4;4;4;4;4;4;9;9;9;9;0
0;6;6;6;6;6;6;6;6;6;6;6;6;6;6;6;6;6;6;6;0;0;0;0;1;1;1;1;1;1;1;0;0;3;0;0;0;0;0;0;0;0;0;0;0;4;4;4;4;4;4;4;4;4;4;4;4;4;4;4;4;4;4;4;9;9;9;0
0;6;6;6;6;6;6;6;6;6;6;6;6;6;6;6;6;6;6;0;0;0;0;0;0;1;1;1;1;1;0;0;3;3;3;0;0;0;0;0;0;0;0;0;4;4;4;4;4;4;4;4;4;4;4;4;4;4;4;4;4;4;4;4;4;9;9;0
0;6;6;6;6;6;6;6;6;6;6;6;6M;6;6;6;6;6;0;0;0;0;0;0;0;0;1;1;1;0;0;3;3;3;3;3;0;0;0;0;0;0;0;4;4;4;4;4;4;4;4;4;4;4;4;4;4;4;4;4;4;4;4;4;4;4;9;0
0;6;6;6;6;6;6;6;6;6;6;6;6;6;6;6;6;0;0;0;0;0;0;0;0;0;0;1;0;0;3;3;3;3;3;3;3;0;0;0;0;0;4;4;4;4;4;4;4;4;4;4;4;4;4;4;4;4;4;4;4;4;4;4;4;4;4;0
0;6;6;6;6;6;6;6;6;6;6;6;6;6;6;6;0;0;0;0;0;0;0;0;0;0;0;0;0;3;3;3;3;3;3;3;3;3;0;0;0;4;4;4;4;4;4;4;4;4;4;4;4;4;4;4;4;4;4;4;4;4;4;4;4;4;4;0
0;6;6;6;6;6;6;6;6;6;6;6;6;6;6;0;0;0;0;0;0;0;0;0;0;0;0;0;3;3;3;3;3;3;3;3;3;3;3;0;4;4;4;4;4;4;4;4;4;4;4;4;4;4;4;4;4;4;4;4;4;4;4;4;4;4;4;0
0;6;6;6;6;6;6;6;6;6;6;6;6;6;0;0;0;0;0;0;0;0;0;0;0;0;0;3;3;3;3;3;3;3;3;3;3;3;3;3;4;4;4;4;4;4;4;4;4;4;4;4;4;4;4;4;4;4;4;4;4;4;4;4;4;4;4;0
0;0;6;6;6;6;6;6;6;6;6;6;6;0;0;0;0;0;0;0;0;0;0;0;0;0;3;3;3;3;3;3;3;3;3;3;3;3;3;3;3;4;4;4;4;4;4;4;4;4;4;4;4;4;4;4;4;4;4;4;4;4;4;4;4;4;4;0
0;0;0;6;6;6;6;6;6;6;6;6;0;0;7;0;0;0;0;0;0;0;0;0;0;3;3;3;3;3;3;3;3;3;3;3;3;3;3;3;3;3;4;4;4;4;4;4;4M;4;4;4;4;4;4;4;4;4;4;4;4;4;4;4;4;4;4;0
0;0;0;0;6;6;6;6;6;6;6;0;0;7;7;7;0;0;0;0;0;0;0;0;3;3;3;3;3;3;3;3;3;3;3;3;3;3;3;3;3;3;3;4;4;4;4;4;4;4;4;4;4;4;4;4;4;4;4;4;4;4;4;4;4;4;4;0
0;0;0;0;0;6;6;6;6;6;0;0;7;7;7;7;7;0;0;0;0;0;0;3;3;3;3;3;3;3;3;3;3;3;3;3;3;3;3;3;3;3;3;3;4;4;4;4;4;4;4;4;4;4;4;4;4;4;4;4;4;4;4;4;4;4;0;0
0;0;0;0;0;0;6;6;6;0;0;7;7;7;7;7;7;7;0;0;0;0;3;3;3;3;3;3;3;3;3;3;3;3;3;3;3;3;3;3;3;3;3;3;3;4;4;4;4;4;4;4;4;4;4;4;4;4;4;4;4;4;4;4;4;0;0;0
0;0;0;0;0;0;0;6;0;0;7;7;7;7;7;7;7;7;7;0;0;3;3;3;3;3;3;3;3;3;3;3;3;3;3;3;3;3;3;3;3;3;3;3;3;3;4;4;4;4;4;4;4;4;4;4;4;4;4;4;4;4;4;4;0;0;0;0
0;0;0;0;0;0;0;0;0;7;7;7;7;7;7;7;7;7;7;7;3;3;3;3;3;3;3;3;3;3;3;3;3;3;3;3;3;3;3;3;3;3;3;3;3;3;3;4;4;4;4;4;4;4;4;4;4;4;4;4;4;4;4;0;0;0;0;0
0;0;0;0;0;0;0;0;7;7;7;7;7;7;7;7;7;7;7;3;3;3;3;3;3;3;3;3;3;3;3;3;3;3;3;3;3;3;3;3;3;3;3;3M;3;3;3;3;4;4;4;4;4;4;4;4;4;4;4;4;4;4;0;0;0;0;0;0
0;0;0;0;0;0;0;7;7;7;7;7;7;7;7;7;7;7;7;3;3;3;3;3;3;3;3;3;3;3;3;3;3;3;3;3;3;3;3;3;3;3;3;3;3;3;3;3;4;4;4;4;4;4;4;2;4;4;4;4;4;0;0;0;0;0;0;0
0;0;0;0;0;0;7;7;7;7;7;7;7;7;7;7;7;7;7;7;3;3;3;3;3;3;3;3;3;3;3;3;3;3;3;3;3;3;3;3;3;3;3;3;3;3;3;8;8;4;4;4;4;4;2;2;2;4;4;4;0;0;0;0;0;0;0;0
0;0;0;0;0;7;7;7;7;7;7;7;7;7;7;7;7;7;7;7;7;3;3;3;3;3;3;3;3;3;3;3;3;3;3;3;3;3;3;3;3;3;3;3;3;3;8;8;8;8;4;4;4;2;2;2;2;2;4;0;0;0;0;0;0;0;0;0
0;0;0;0;7M;7;7;7;7;7;7;7;7;7;7;7;7;7;7;7;7;7;3;3;3;3;3;3;3;3;3;3;3;3;3;3;3;3;3;3;3;3;3;3;3;8;8;8;8;8;8;4;2;2;2;2;2;2;2;0;0;0;0;0;0;0;0;0
0;0;0;7;7;7;7;7;7;7;7;7;7;7;7;7;7;7;7;7;7;7;3;3;3;3;3;3;3;3;3;3;3;3;3;3;3;3;3M;3;3;3;3;3;3;8;8;8;8;8;8;2;2;2;2;2;2;2;2;2;0;0;0;0;0;0;0;0
0;0;7;7;7;7;7;7;7;7;7;7;7;7;7;7;7;7;7;7;7;7;7;3;3;3;3;3;3;3;3;3;3;3;3;3;3;3;3;3;3;3;3;3;8;8;8;8;8;8;2;2;2;2;2;2;2;2;2;2;2;0;0;0;0;0;0;0
0;7;7;7;7;7;7;7;7;7;7;7;7;7;7;7;7;7;7;7;7;7;7;7;3;3;3;3;3;3;3;3;3;3;3;3;3;3;3;3;3;3P;3;8;8;8;8;8;8;2;2;2;2;2;2;2;2;2;2;2;2;2;0;0;0;0;0;0
0;7;7;7;7;7;7;7;7;7;7;7;7;7;7;7;7;7;7;7;7;7;7;7;7;3;3;3;3;3;3;3;3;3;3;3;3;3;3;3;3;3;8;8;8;8;8;8;2;2;2;2;2;2;2;2;2;2;2;2;2;2;0;0;0;0;0;0
0;7;7;7;7;7;7;7;7;7;7;7;7;7;7;7;7;7;7;7;7;7;7;7;7;7;3;3;3;3;3;3;3;3;3;3;3;3;3;3;3;8;8;8;8;8;8;8;2;2;2;2;2;2;2;2;2;2;2;2;2;2;2;0;0;0;0;0
0;7;7;7;7;7;7;7;7;7;7;7;7;7;7;7;7;7;7;7;7;7;7;7;7;7;7;3;3;3;3;3;3;3;3;3;3;3;3;3;8;8;8;8;8;8;8;2;2;2M;2;2;2;2;2;2;2;2;2;2;2;2;2;2;0;0;0;0
0;7;7;7;7;7;7;7;7;7;7;7;7;7;7;7;7;7;7;7;7;7;7;7;7;7;7;7;3;3;3;3;3;3;3;3;3;3;3;8;8;8;8;8;8;8;2;2;2;2;2;2;2;2;2;2;2;2;2;2;2;2;2;2;2;0;0;0
0;7;7;7;7;7;7;7;7;7;7;7;7;7;7;7;7;7;7;7;7;7;7;7;7;7;7;7;8;3;3;3;3;3;3;3;3;3;8;8;8;8;8;8;8;2;2;2;2P;2;2;2;2;2;2;2;2;2;2;2;2;2;2;2;2;2;0;0
0;0;7;7;7;7;7;7;7;7;7;7;7;7;7;7;7;7;7;7;7;7;7;7;7;7;7;8;8;8;3;3;3;3;3;3;3;8;8;8;8;8;8;8;2;2;2;2;2;2;2;2;2;2;2;2;2;2;2;2;2;2;2;2;2;2;2;0
0;0;0;7;7;7;7;7;7;7;7;7;7;7;7;7;7;7;7;7;7;7;7;7;7;7;8;8;8;8;8;3;3;3;3;3;8;8;8;8;8;8;8;2;2;2;2;2;2;2;2;2;2;2;2;2;2;2;2;2;2;2;2;2;2;2;2;0
0;0;0;0;7;7;7;7;7;7;7;7;7;7;7;7;7;7;7;7;7;7;7;7;7;8;8;8;8;8;8;8;3;3;3;8;8;8;8;8;8;8;2;2;2;2;2;2;2;2;2;2;2;2;2;2;2;2;2;2;2;2;2;2;2;2;2;0
0;0;0;0;0;7;7;7;7;7;7;7;7;7;7;7;7;7;7;7;7;7;7;7;8;8;8;8;8;8;8;8;8;3;8;8;8;8;8;8;8;2;2;2;2;2;2;2;2;2;2;2;2;2;2;2;2;2;2;2;2;2;2;2;2;2;2;0
0;0;0;0;0;0;7;7;7;7;7;7;7;7;7;7;7;7;7;7;7;7;7;8;8;8;8;8;8;8;8;8;8;8;8;8;8;8;8;8;2;2;2;2;2;2;2;2;2;2;2;2;2;2;2;2;2;2;2;2;2;2;2;2;2;2;2;0
0;0;0;0;0;0;0;7;7;7;7;7;7;7;7;7;7;7;7;7;7;7;8;8;8;8;8;8;8;8;8;8;8;8;8;8;8;8;8;2;2;2;2;2;2;2;2;2;2;2;2;2;2;2;2;2;2;2;2;2;2;2;2;2;2;2;2;0
0;0;0;0;0;0;0;0;7;7;7;7;7;7;7;7;7;7;7;7;7;8;8;8;8;8;8;8;8;8;8;8;8;8;8;8;8;8;2;2;2;2;2;2;2;2;2;2;2;2;2;2;2;2;2;2;2;2;2;2;2;2;2;2;2;2;2;0
0;0;0;0;0;0;0;0;7;7;7;7;7;7;7;7;7;7;7;7;8;8;8;8;8;8;8;8;8;8;8;8;8;8;8;8;8;2;2;2;2;2;2;2;2;2;2;2;2;2;2;2;2;2;2P;2;2;2;2;2;2;2;2;2;2;2;2;0
0;0;0;0;0;0;0;0;0;7;7;7;7;7;7;7;7;7;7;7;8;8;8;8;8;8;8;8;8;8;8;8;8;8;8;8;8;8;2;2;2;2;2;2;2;2;2;2;2;2;2;2;2;2;2;2;2;2;2;2;2;2;2;2;2;2;2;0
0;0;0;0;0;0;0;0;0;0;7;7;7;7;7;7;7;7;7;8;8;8M;8;8;8M;8;8;8;8;8;8;8;8;8;8;8;8;8;8;2;2;2;2;2;2;2;2;2;2;2;2;2;2;2;2;2;2;2;2;2;2;2;2;2;2;2;2;0
0;0;0;0;0;0;0;0;0;0;0;7;7;7;7;7;7M;7;8;8;8;8;8;8;8;8;8;8;8;8;8;8;8;8;8;8;8;8;8;8;2;2;2;2;2;2;2;2;2;2;2;2;2;2;2;2;2;2;2;2;2;2;2;2;2;2;2;0
0;0;0;0;0;0;0;0;0;0;0;0;7;7;7;7;7;8;8;8;8;8;8;8;8;8;8;8;8;8;8;8;8;8;8;8;8;8;8;8;8;2;2;2;2;2;2;2;2;2;2;2;2;2;2;2;2;2;2;2;2;2;2;2;2;2;2;0
0;0;0;0;0;0;0;0;0;0;0;0;0;7;7;7;8;8;8;8;8;8;8;8;8;8;8;8;8;8;8;8;8;8;8;8;8;8;8;8;8;8;2;2;2;2;2;2;2;2;2;2;2;2;2;2;2;2;2;2;2;2;2;2;2;2;2;0
0;0;0;0;0;0;0;0;0;0;0;0;0;0;0;0;0;0;0;0;0;0;0;0;0;0;0;0;0;0;0;0;0;0;0;0;0;0;0;0;0;0;0;0;0;0;0;0;0;0;0;0;0;0;0;0;0;0;0;0;0;0;0;0;0;0;0;0
