64 64
6
12
9
50 11
0;0;0;0;0;0;0;0;0;0;0;0;0;0;0;0;0;0;0;0;0;0;0;0;0;0;0;0;0;0;0;0;0;0;0;0;0;0;0;0;0;0;0;0;0;0;0;0;0;0;0;0;0;0;0;0;0;0;0;0;0;0;0;0
0;2;2;2;2;2;2;2;2;2;2;2;2;2;2;2;2;2;2;2;2;2;2;2;2;2;2;2;2;2;2;8;8;8;4;4;4;4;4;4;4;4;4;4;4;4;4;4;4;4;4;4;4;4;4;4;4;4;4;4;4;4;4;0
0;2;2;2;2;2;2;2;2;2;2;2;2;2;2;2;2;2;2;2;2;2;2;2;2;2;2;2;2;2;2;8;8;4;4;4;4;4;4;4;4;4;4;4;4;4;4;4;4;4;4;4;4;4;4;4;4;4;3;4;4;4;4;0
0;2;2;2;2;2;2;2;2;2;2;2;2;2;2;2;2;2;2;2;2;2;2;2;2;2;2;2;2;2;8;8;4;4;4;4;4;4;4;4;4;4;4;4;4;4;4;4;4;4;4;4;4;4;4;4;4;3;3;4;4;4;4;0
0;2;2;2;2;2;2;2;2;2;2;2;2;2;2;2;2;2;2;2;2;2;2;2;2;2;2;2;2;8;8;4;4;4;4;4;4;4;4;4;4;4;4;4;4;4;4;4;4;4;4;4;4;4;4;4;4;3;3;3;4;4;0;0
0;2;2;2;2;2;2;2;2;2;2;2;2;2;2;2;2;2;2;2;2;2;2;2;2;2;2;2;8M;8;4;4;4;4;4;4;4;4;4;4;4;4;4;4;4;4;4;4;4;4;4;4;4;4;4;4;3;3;3;3;3;0;0;0
0;2;2;2;2;2;2;2;2;2;2;2;2;2;2;2;2;2;2;2;2;2;2;2;2;2;2;8;8;4;4;4;4;4;4;4;4;4;4;4;4;4;4;4;4;4;4;4;4;4;4;4;4;4;4;3;3;3;3;3;3;3;0;0
0;2;2;2;2;2;2;2;2;2;2;2;2;2;2;2;2;2;2;2;2;2;2;2;2;2;8;8;4;4;4;4;4;4;4;4;4;4;4;4;4;4;4;4;4;4;4;4;4;4;4;4;4;4;3;3;3;3;3;3;3;3;3;0
0;2;2;2;2;2;2;2;2;2;2;2;2;2;2;2;2;2;2;2;2;2;2;2;2;8;8;4;4;4;4;4;4;4;4;4;4;4;4;4;4;4;4;4;4;4;4;4;4;4;4;4;4;3;3;3;3;3;3;3;3;3;3;0
0;2;2;2;2;2;2;2;2;2;2;2;2;2;2;2;2;2;2;2;2;2;2;2;8;8;4;4;4;4;4;4;4;4;4;4;4;4;4;4;4;4;4;4;4;4;4;4;4;4;4;4;3;3;3;3;3;3;3;3;3;3;3;0
0;2;2;2;2;2;2;2;2;2;2;2;2;2;2;2;2;2;2;2;2;2;2;8;8;4;4;4;4;4;4;4;4;4;4;4;4;4;4;4;4;4;4;4;4;4;4;4;4;4;4;3;3;3;3;3;3;3;3;3;3;3;3;0
0;2;2;2;2;2;2;2;2;2;2;2;2;2;2;2;2;2;2;2;2;2;8;8;8;4;4;4;4;4;4;4;4;4;4;4;4;4;4;4;4;4;4;4;4;4;4;4;4;4;3;3;3;3;3;3;3;3;3;3;3;3;3;0
0;2;2;2;2;2;2;2;2;2;2;2;2;2;2;2;2;2;2;2;2;8;8;8;8;8;4;4;4;4;4;4;4;4;4;4;4;4;4;4;4;4;4;4;4;4;4;4;4;3;3;3;3;3;3;3;3;3;3;3;3;3;3;0
0;2;2;2;2;2;2;2;2;2;2;2;2;2;2;2;2;2;2;2;8;8;8;8;8;8;8;4;4;4;4;4;4;4;4;4;4;4;4;4;4;4;4;4;4;4;4;4;3;3;3;3;3;3;3;3;3;3;3;3;3;3;3;0
0;2;2;2;2;2;2;2;2;2;2;2;2;2;2;2;2;2;2;8;8;8;8;8;8;8;8;8;4;4;4;4;4;4;4;4;4;4;4;4;4;4;4;4;4;4;4;3;3;3;3;3;3;3;3;3;3;3;3;3;3;3;3;0
0;2;2;2;2;2;2;2;2;2;2;2;2;2;2;2;2;2;8;8;8;8;8;8;8;8;8;8;8;4;4;4;4;4;4;4;4;4;4;4;4;4;4;4;4;4;3;3;3;3;3;3;3;3;3;3;3;3;3;3;3;3;3;0
0;2;2;2;2;2;2;2;2;2;2;2;2;2;2;2;2;8;8;8;8;8;8;8;8;8;8;8;8;8;4;4;4;4;4;4;4;4;4;4;4;4;4;4;4;3;3;3;3;3;3;3;3;3;3;3;3;3;3;3;3;3;3;0
0;2;2;2;2;2;2;2;2;2;2;2;2;2;2;2;8;8;8;8;8;8;8;8;8;8;8;8;8;8;8;4;4;4;4;4;4;4;4;4;4;4;4;4;3;3;3;3;3;3;3;3;3;3;3;3;3;3;3;3;3;3;3;0
0;2;2;2;2;2;2;2;2;2;2;2;2;2;2;8;8;8;8;8;8;8;8;8;8;8;8;8;8;8;8;8;4;4;4;4;4;4;4;4;4;4;4;3;3;3;3;3;3;3;3;3;3;3;3;3;3;3;3;3;3;3;3;0
0;2;2;2;2;2;2;2;2;2;2;2;2;2;8;8;8;8;8;8;8;8;8;8;8;8;8;8;8;8;8;8;6;4;4;4;4;4;4;4;4;4;3;3;3;3;3;3;3;3;3;3;3;3;3;3;3;3;3;3;3;3;3;0
0;2;2;2;2M;2;2;2;2;2;2;2;2;8;8;8;8;8;8;8;8;8;8;8;8;8;8;8;8;8;8;6;6;6;4;4;4;4;4;4;4;3;3;3;3;3;3;3;3;3;3;3;3;3;3;3;3;3;3;3;3;3;3;0
0;2;2;2;2;2;2;2;2;2;2;2;8;8;8;8;8;8;8;8;8;8;8;8;8;8;8;8;8;8;6;6;6;6;6;4;4;4;4;4;4;4;3;3;3;3;3;3;3;3;3;3;3;3;3;3;3;3;3;3;3;3;3;0
0;2;2;2;2;2;2;2;2;2;2;8;8;8;8;8;8;8;8;8;8;8;8;8;8;8;8;8;8;6;6;6;6;6;6;6;4;4;4;4;4;4;4;3;3;3;3;3;3;3;3;3;3;3;3;3;3;3;3;3;3;3;3;0
0;2;2;2;2;2;2;2;2;2;8;8;8;8;8;8;8;8;8;8;8;8;8;8;8;8;8;8;6;6;6;6;6;6;6;6;6;4;4;4;4;4;4;4;3;3;3;3;3;3;3;3;3;3;3;3;3;3;3;3;3;3;3;0
0;7;2;2;2;2;2;2;2;8;8;8;8;8;8;8;8;8;8;8;8;8;8;8;8;8;8;6;6;6;6;6;6;6;6;6;6;6;4;4;4;4;4;6;6;3;3;3;3;3;3;3;3;3;3;3;3;3;3;3;3;3;3;0
0;7;7;2;2;2;2;2;7;8;8;8;8;8;8;8;8;8;8;8;8;8;8;8;8;8;6;6;6;6;6;6;6;6;6;6;6;6;6;4;4;4;6;6;6;6;3;3;3;3;3;3;3;3;3;3;3;3;3;3;3;3;3;0
0;7;7;7;2;2;2;7;7;7;8;8;8;8;8M;8;8;8;8;8;8;8;8;8;8;6;6;6;6;6;6;6;6;6;6;6;6;6;6;6;4;6;6;6;6;6;6;3;3;3;3;3;3;3;3;3;3;3;3;3;3;3;3;0
0;7;7;7;2;2;2;7;7;7;7;8;8;8;8;8;8;8;8;8;8;8;8;8;6;6;6;6;6;6;6;6;6;6;6;6;6;6;6;6;4;6;6;6;6;6;6;6M;3;3;3;3;3;3;3;3;3;3;3;3;3;3;3;0
0;7;7;7;7;2;7;7;7;7;7;7;8;8;8;8;8;8;8;8;8;8;8;6;6;6;6;6;6;6;6;6;6;6;6;6;6;6;6M;6;6;6;6;6;6;6;6;6;6;3;3;3;3;3;3;3;3;3;3;3;3;3;3;0
0;7;7;7;7P;7;7;7;7;7;7;7;7;8;8;8;8;8;8;8;8;8;8;6;6;6;6;6;6;6;6;6;6;6;6;6;6;6;6;6;6;6;6;6;6;6;6;6;6;6;3;3;3;3;3;3;3;3;3;3;3;3;3;0
0;7;7;7;7;7;7;7;7;7;7;7;7;7;8;8;1M;8;8;8;8;8;8;8;6;6;6;6;6;6;6;6;6;6;6;6;6;6;6;6;6;6;6;6;6;6;6;6;6;6;6;3;3;3;3;3;3;3;3;3;3;3;3;0
0;7;7;7;7;7;7;7;7;7;7;7;7;7;7;1;1;1;8;8;8;8;8;8;8;6;6;6;6;6;6;6;6;6;6;6;6;6;6;6;6;6;6;6;6;6;6;6;6;6;6;6;3;3;3;3;3;3;3;3;3;3;3;0
0;7;7;7;7;7;7P;7;7;7;7;7;7;7;1;1;1;1;1;8;8;8;8;8;8;8;6;6;6;6;6P;6;6;6;6;6;6;6;6;6;6;6;6;6;6;6;6;6;6;6;6;6;6;3;3;3;3;3;3;3;3;3;3;0
0;7;7;7;7;7;7;7;7;7;7;7;7;1;1;1;1;1;1;1;8;8;8;8;8;8;8;6;6;6;6;6;6;6;6;6;6;6;6;6;6;6;6;6;6;6;6;6;6;6;6;6;6;6;3;3;3;3;3;3;3;3;3;0
0;7;7;7;7;7;7;7;7;7;7;7;1;1;1;1;1;1;1;1;1;8;8;8;8;8;8;8;6;6;6;6;6;6;6;6;6;6;6;6;6;6;6;6;6;6;6;6;6;6;6;6;6;6;6;3;3;3;3;3;3;3;0;0
0;7;7;7;7;7;7;7;7;7;7;1;1;1;1;1;1;1;1;1;1;1;8;8;8;8;8;8;8;6;6;6;6;6;6;6;6;6;6;6;6;6;6;6;6;6;6;6;6;6;6;6;6;6;0;0;3;3;3;3;3;0;0;0
0;7;7;7;7;7;7;7;7;7;1;1;1;1;1;1;1;1;1;1;1;1;1;8;8;8;8;8;8;8;6;6;6;6;6;6;6;6;6;6;6;6;6;6;6;6;6;6;6;6;6;6;6;0;0;0;0;3;3;3;0;0;0;0
0;7;7;7;7;7;7;7;7;1;1;1;1;1;1;1;1;1;1;1;1;1;1;1;8;8;8;8;8;8;8;6;6;6;6;6;6P;6;6;6;6;6;6;6;6;6;6;6;6;6;6;6;0;0;0;0;0;0;3;0;0;0;0;0
0;7;7;7;7;7;7;7;1;1;1;1;1;1;1;1;1;1;1;1;1;1;1;1;1;8;8;8;8;8;8;8;6;6;6;6;6;6;6;6;6;6;6;6;6;6;6;6;6;6;6;0;0;0;0;0;0;0;0;0;0;0;0;0
0;7;7;7;7;7;7;1;1;1;1;1;1;1;1;1;1;1;1;1;1;1;1;1;1;1;8;8;8;8;8;8;8;6;6;6;6;6;6;6;6;6;6;6;6;6;6;6;6;6;0;0;0;0;0;0;0;0;0;0;0;0;0;0
0;7;7;7;7;7;1;1;1;1;1;1;1;1;1;1;1;1;1;1;1;1;1;1;1;1;1;8;8;8;8;8;8;8;6;6;6;6;6;6;6;6;6;6;6;6;6;6;6;0;5;0;0;0;0;0;0;0;0;0;0;0;0;0
0;7;7;7;7;1;1;1;1;1;1;1;1;1;1;1;1;1;1;1;1;1;1;1;1;1;1;1;8;8;8;8;8;8;8;6;6;6;6;6;6;6;6;6;6;6;6;6;0;5;5;5;0;0;0;0;0;0;0;0;0;0;0;0
0;7;7;7;1;1;1;1;1;1;1;1;1;1;1;1;1;1;1;1;1;1;1;1;1;1;1;1;1M;8;8;8;8;8;8;8;6;6;6;6;6;6;6;6;6;6;6;0;5;5;5;5;5;0;0;0;0;0;0;0;0;0;0;0
0;7;7;1;1;1;1;1;1;1;1;1;1;1;1;1;1;1;1;1;1;1;1;1;1;1;1;1;1;8;8;8;8;8;8;8;8;6;6;6;6;6;6;6;6;6;0;5;5;5;5;5;5;5;0;0;0;0;0;0;0;0;0;0
0;7;7;1;1;1;1;1;1;1;1;1;1;1;1;1;1;1;1;1;1;1;1;1;1;1;1;1;1;1;8;8;8;8;8;8;8;8;6;6;6P;6;6;6;6;0;5;5;5;5;5;5;5;5M;5;0;0;0;0;0;0;0;0;0
0;7;1;1;1;1;1;1;1;1;1;1;1;1;1;1;1;1;1;1;1;1;1;1;1;1;1;1;1;1;1;8;8P;8;8;8;8;8;8;6;6;6;6;6;0;5;5;5;5;5;5;5;5;5;5;5;0;0;0;0;0;0;0;0
0;7;7;1;1;1;1;1;1;1;1;1;1;1;1;1;1;1;1;1;1;1;1;1;1;1;1;1;1;1;8;8;8;8;8;8;8;8;8;8;6;6;6;0;5;5;5;5;5;5;5;5;5;5;5;5;5;0;0;0;0;0;0;0
0;7;7;7;1;1;1;1;1;1;1;1;1;1;1;1;1;1;1;1;1;1;1;1;1;1;1;1;1;8;8;8;8;8;8;8;8;8;8;0;0;6;0;5;5;5;5;5;5;5;5;5;5;5;5;5;5;5;0;0;0;0;0;0
0;7;7;7;7;1;1;1;1;1;1;1;1;1;1;1;1;1;1;1;1;1;1;1;1;1;1;1;8;8;8;8;8;8;8;8;8;8;0;0;0;0;5;5;5;5;5;5;5;5;5;5;5;5;5;5;5;5;5;0;0;0;0;0
0;7;7;7;7;7;1;1;1;1;1;1;1;1;1;1;1;1;1;1;1;1;1;1;1;1;1;8;8;8;8;8;8;8;8;8;8;8;0;0;0;5;5;5;5;5;5;5;5;5;5;5;5;5;5;5;5;5;5;5;0;0;0;0
0;7;7;7;7;7;7;1;1;1;1;1;1;1;1;1;1;1;1;1;1;1;1;1;1;1;7;7;8;8;8;8;8;8;8;8;8;0;0;0;5;5;5;5;5;5;5;5;5;5;5;5;5;5;5;5;5;5;5;5;5;0;0;0
0;7;7;7;7;7;7;7;1;1;1;1;1;1;1;1;1;1;1;1;1;1;1;1;1;7;7;7;7;8;8;8;8;8;8;8;0;0;0;5;5;5;5;5;5;5;5;5;5;5;5;5;5;5;5;5;5;5;5;5;5;5;0;0
0;7;7;7;7;7;7;7;7;1;1;1;1;1;1;1;1;1;1;1;1;1;1;1;7;7;7;7;7;7;8;8;8;8;8;0;0;0;5;5;5;5;5;5;5;5;5;5;5;5;5;5;5;5;5;5;5;5;5;5;5;5;5;0
0;7;7;7;7;7;7;7;7;7;1;1;1;1;1;1;1;1;1;1;1;1;1;7;7;7;7;7;7;7;8;8;8;8;0;0;0;5;5;5;5;5;5;5;5;5;5;5;5;5;5;5;5;5;5;5;5;5;5;5;5;5;5;0
0;7;7;7;7;7;7;7;7;7;7;1;1;1;1;1;1;1;1;1;1;1;7;7;7;7;7;7;7;7;7;8;8;0;0;0;5;5;5;5;5;5;5;5;5;5;5;5;5;5;5;5;5;5;5;5;5;5;5;5;5;5;5;0
0;7;7;7;7;7;7;7;7;7;7;7;1;1;1;1;1;1;1;1;1;7;7;7;7;7;7;7;7;7;7;7;0;0;0;5;5;5;5;5;5;5;5;5;5;5;5;5;5;5;5;5;5;5;5;5;5;5;5;5;5;5;5;0
0;7;7;7;7;7;7;7;7;7;7;7;7;1;1;1;1;1;1;1;7;7;7M;7;7;7;7;7;7;7;7;7;7;0;5;5;5;5;5;5;5;5;5;5;5;5;5;5;5;5;5;5;5;5;5;5;5;5;5;5;5;5P;5;0
0;7;7;7;7;7;7;7;7;7;7;7;7;7;1;1;1;1;1;7;7;7;7;7;7;7;7;7;7;7;7;7;7;5;5;5;5;5;5;5;5;5;5;5;5;5;5;5;5;5;5;5;5;5;5;5;5;5;5;5;5;5;5;0
0;7;7;7;7;7;7;7;7;7;7;7;7;7;7;1;1;1;7;7;7;7;7;7;7;7;7;7;7;7;7;7;5;5;5;5;5;5;5;5;5;5;5;5;5;5;5;5;5;5;5;5;5;5;5;5;5;5;5;5;5;5;5;0
0;7;7;7;7;7;7;7;7;7;7;7;7;7;7;7;1;7;7;7;7;7;7;7;7;7;7;7;7;7;7;5;5;5;5;5;5;5;5;5;5;5;5;5;5;5;5;5;5;5;5;5;5;5;5;5;5;5;5;5;5;5;5;0
0;7;7;7;7;7;7;7;7;7;7;7;7;7;7;7;7;7;7;7;7;7;7;7;7;7;7;7;7;7;5;5;5;5;5;5;5;5;5;5;5;5;5;5;5;5;5;5;5;5;5;5;5;5;5;5;5;5;5;5;5;5;5;0
0;7;7M;7;7;7;7;7;7;7;7;7;7;7;7;7;7;7;7;7;7;7;7;7;7;7;7;7;7;5;5;5;5;5;5;5;5;5;5;5;5;5;5;5;5;5;5;5;5;5;5;5;5;5;5;5;5;5;5;5;5;5;5;0
0;7;7;7;7;7;7;7;7;7;7;7;7;7;7;7;7;7M;7;7;7;7;7;7;7;7;7;7;7;7;5;5;5;5;5;5;5;5;5;5;5;5;5;5;5;5;5;5;5;5;5;5;5;5;5;5;5;5;5;5;5;5;5;0
0;0;0;0;0;0;0;0;0;0;0;0;0;0;0;0;0;0;0;0;0;0;0;0;0;0;0;0;0;0;0;0;0;0;0;0;0;0;0;0;0;0;0;0;0;0;0;0;0;0;0;0;0;0;0;0;0;0;0;0;0;0;0;0
