70 70
6
12
11
56 9
0;0;0;0;0;0;0;0;0;0;0;0;0;0;0;0;0;0;0;0;0;0;0;0;0;0;0;0;0;0;0;0;0;0;0;0;0;0;0;0;0;0;0;0;0;0;0;0;0;0;0;0;0;0;0;0;0;0;0;0;0;0;0;0;0;0;0;0;0;0
0;2;2;2;2;2;2;2;2;2;2;2;2;2;2;2;2;2;2;2;2;2;2;2;2;2;2;2;2;2;6;6;6;6;6;6;6;6;6;6;6;6;6;6;6;6;6;6;6;6;6;6;6;6;6;6;10;10;10;10;10;10;10;10;10;10;10;10;10;0
0;2;2;2;2;2;2;2;2;2;2;2;2;2;2;2;2;2;2;2;2;2;2;2;2;2;2;2;2;6;6;6M;6;6;6;6;6;6;6;6;6;6;6;6;6;6;6;6;6;6;6;6;6;6;6;6;6;10;10;10;10;10;10;10;10;10;10;10;10;0
0;2;2;2;2;2;2;2;2;2;2;2;2;2;2;2P;2;2;2;2;2;2;2;2;2;2;2;2;6;6;6;6;6;6;6;6;6;6;6;6;6;6;6;6;6;6;6;6;6;6;6;6;6;6;6;6;6;6;10;10;10;10;10;10;10;10;10;10;10;0
0;2;2;2;2;2;2;2;2;2;2;2;2;2;2;2;2;2;2;2;2;2;2;2;2;2;2;6;6;6;6;6;6;6;6;6;6;6;6;6;6;6;6;6;6;6;6;6;6;6;6;6;6;6;6;6;6;6;6;10;10;10;10;10;10;10;10;10;10;0
0;2;2;2;2;2;2;2;2;2;2;2;2;2;2;2;2;2;2;2;2;2;2;2;2;2;2;6;6;6;6;6;6;6;6;6;6;6;6;6;6;6;6;6;6;6;6;6;6;6;6;6;6;6;6;6;6;6;6;10;10;10;10;10;10;10;10;10;10;0
0;2;2;2;2;2;2;2;2;2;2;2;2;2;2;2;2;2;2;2;2;2;2;2;2;2;6;6;6;6;6;6;6;6;6;6;6;6;6;6;6;6;6;6;6;6;6;6;6;6;6;6;6;6;6;6;6;6;10;10;10;10;10;10;10;10;10;10;10;0
0;2;2;2;2;2;2;2;2;2;2;2;2;2;2;2;2;2;2;2;2;2M;2;2;2;6;6;6M;6;6;6;6;6;6;6;6;6;6;6;6;6;6;6;6;6;6;6;6;6;6P;6;6;6;6;6;6;6;10;10;10;10;10;10;10;10;10;10;10;10;0
0;2;2;2;2;2;2;2;2;2;2;2;2;2;2;2;2;2;2;2;2;2;2;2;6;6;6;6;6;6;6;6;6;6;6;6;6;6;6;6;6;6;6;6;6;6;6;6;6;6;6;6;6;6;6;6;0;7;10;10;10;10;10;10;10;10;10;10;10;0
0;2;2;2;2;2;2;2;2;2;2;2;2;2;2;2;2;2;2;2;2;2;2;6;6;6;6;6;6;6;6;6;6;6;6;6;6;6;6;6;6;6;6;6;6;6;6;6;6;6;6;6;6;6;6;0;7;7;7;10;10;10;10;10;10;10;10;10;10;0
0;2;2;2;2;2;2;2;2;2;2;2;2;2;2;2;2;2;2;2;2;2;6;6;6;6;6;6;6;6;6;6;6;6;6;6;6;6;6;6;5;6;6;6;6;6;6;6;6;6;6;6;6;6;0;7;7;7;7;7;10;10;10;10;10;10;10;10;10;0
0;2;2;2;2;2;2;2;2;2;2;2;2;2;2;2;2;2;2;2;2;0;0;6;6;6;6;6;6;6;6;6;6;6;6;6;6;6;6;5;5;5;6;6;6;6;6;6;6;6;6;6;6;0;7;7;7;7;7;7;7;10;10;10;10;10;10;10;10;0
0;2;2;2;2;2;2;2;2;2;2;2;2;2;2;2;2;2;2;2;0;0;0;0;6;6;6;6;6;6;6;6;6;6;6;6;6;6;5;5;5;5;6;6;6;6;6;6;6;6;6;6;0;7;7;7;7;7;7;7;7;7;10;10;10;10;10;10;10;0
0;2;2;2;2;2;2;2;2;2;2;2;2;2;2;2;2;2;2;0;0;0;0;0;0;6;6;6;6;6;6;6;6;6;6;6;6;6;5;5;5;5;5;6;6;6;6;6;6;6;6;0;7;7;7;7;7;7;7;7;7;7;7;10;10;10;10;10;10;0
0;2;2;2;2;2;2;2;2;2;2;2;2;2;2;2;2;2;0;0;0;0;0;0;0;0;6;6;6;6;6;6;6;6;6;6;6;5;5;5;5;5;5;5;6;6;6;6;6;6;0;7;7;7;7;7;7;7;7;7;7;7;7;10;10;10;10;10;10;0
0;2;2;2;2;2;2;2;2;2;2;2;2;2;2;2;2;0;0;0;0;0;0;0;0;0;0;6;6;6;6;6;6;6;6;6;5;5;5;5;5;5;5;5;5;6;6;6;6;0;0;7;7;7;7;7;7;7;7;7;7;7;7;7;10;10;10;10;10;0
0;2;2;2;2;2;2;2;2;2;2;2;2;2;2;2;0;0;0;0;0;0;0;0;0;0;0;0;6;6;6;6;6;6;6;5;5;5;5;5;5;5;5;5;5;5;6;6;6;0;7;7;7;7;7;7;7;7M;7;7;7;7;7;7;7;10;10;10;10;0
0;2;2;2;2;2;2;2;2;2;2;2;2;2;2;0;0;0;0;0;0;0;0;0;0;0;0;0;0;6;6;6;6;6;5;5;5;5;5;5;5;5;5;5;5;5;5;6;0;7;7;7;7;7;7;7;7;7;7;7;7;7;7;7;7;7;10;10;10;0
0;2;2;2;2;2;2;2;2;2;2;2;2;2;0;0;0;0;0;0;0;0;0;0;0;0;0;0;0;0;6;6;6;5;5;5;5;5;5;5;5;5;5;5;5;5;5;5;7;7;7;7;7;7;7;7;7;7;7;7;7;7;7;7;7;7;7;10;10;0
0;2;2;2;2;2;2;2;2;2;2;2;2;0;0;0;0;0;0;0;0;0;0;0;0;0;0;0;0;0;0;6;5;5;5;5;5;5;5;5;5;5;5;5;5;5;5;5;5;7;7;7;7;7;7;7;7;7;7;7;7;7;7;7;7;7;7;7;10;0
0;2;2;2;2;2;2;2;2;2;2;2;0;1;0;0;0;0;0;0;0;0;0;0;0;0;0;0;0;0;0;5;5;5;5;5;5;5;5;5;5;5;5;5;5;5;5;5;5;5;7;7;7;7;7;7;7;7;7;7;7;7P;7;7;7;7;7;7;7;0
0;2;2;2;2;2;2;2;2;2;2;0;1;1;1;0;0;0;0;0;0;0;0;0;0;0;0;0;0;0;5;5;5;5;5;5;5;5;5;5;5;5;5;5;5;5;5;5;5;5;5;7;7;7;7;7;7;7;7;7;7;7;7;7;7;7;7;7;7;0
0;2;2;2;2;2;2;2;2;2;0;1;1;1;1;1;0;0;0;0;0;0;0;0;0;0;0;0;0;5;5;5;5;5;5;5;5;5;5;5;5;5;5;5;5;5;5;5;5;5;5;5;7;7;7;7;7;7;7;7;7;7;7;7;7;7;7;7;7;0
0;2;2;2;2;2;2;2;2;0;1;1;1;1;1;1;1;0;0;0;0;0;0;0;0;0;0;0;5;5;5;5;5;5;5;5;5;5;5;5;5;5;5;5;5;5;5;5;5;5;5;5;5;7;7;7;7;7;7;7;7;7;7;7;7;7;7;7;7M;0
0;2;2;2;2;2;2;2;0;1;1;1;1;1;1;1;1;1;0;0;0;0;0;0;0;0;0;5;5;5;5;5;5;5;5;5;5;5;5;5;5;5;5;5;5;5;5;5;5;5;5;5;5;5;7;7;7;7;7;7;7;7;7;7;7;7;7;7;7;0
0;0;2;2;2;2;2;0;1;1;1;1;1;1;1;1;1;1;1;0;0;0;0;0;0;0;5;5;5;5;5;5;5;5;5;5;5;5;5;5;5;5;5;5;5;5;5;5;5;5;5;5;5;5;5;7;7;7;7;7;7;7;7;7;7;7;7;7;7;0
0;0;0;2;2;2;0;1;1;1;1;1;1;1;1;1;1;1;1;1;0;0;0;0;0;0;0;5;5;5;4;5;5;5;5;5;5;5;5;5;5;5;5;5;5;5;5;5;5;5;5;5;5;5;5;5;7;7;7;7;7;7;7;7;7;7;7;7;7;0
0;0;0;0;2;0;1;1;1;1;1;1;1;1;1;1;1;1;1;1;1;0;0;0;0;0;0;0;5;4;4;4;5;5;5;5;5;5;5;5;5;5;5;5;5;5;5;5M;5;5;5;5;5;5;5;5;5;7;7;7;7;7;7;7;7;7;7;7;7;0
0;0;0;0;0;1;1;1;1;1;1;1;1;1;1;1;1;1;1;1;1;1;0;0;0;0;0;0;4;4;4;4;4;5;5;5;5;5;5;5;5;5;5;5;5;5;5;5;5;5;5;5;5;5;5;5;7;7;7;7;7;7;7;7;7;7;7;7;7;0
0;0;0;0;1;1;1;1;1;1;1;1;1;1;1;1;1;1;1;1;1;1;1;0;0;0;0;4;4;4;4;4;4;4M;5;5;5;5;5;5;5;5;5;5;5;5;5;5;5;5;5;5;5;5;5;7;7;7;7;7;7;7;7;7;7;7;7;7;7M;0
0;0;0;1;1;1;1;1;1;1;1;1;1;1;1;1;1;1;1;1;1;1;1;1;0;0;4;4;4;4;4;4;4;4;4;5;5;5;5;5;5;5;5;5;5;5;5;5;5;5;5;5;5;5;7;7;7;7;7;7;7;7;7;7;7;7;7;7;7;0
0;0;1;1;1;1;1;1;1;1;1;1;1;1;1;1;1;1;1;1;1;1;1;1;1;4;4;4;4;4;4;4;4;4;4;4;5M;5;5;5;5;5;5;5;5;5;5;5;5;5;5;5;5;7;7;7;7;7;7;7;7;7;7;7;7;7;7;7;7;0
0;1;1;1;1;1;1;1;1;1;1;1;1;1;1;1;1;1;1;1;1;1;1;1;1;1;4;4;4;4;4;4;4;4;4;4;4;5;5;5;5;5;5;5;5;5;5;5;5;5;5;5;7;7;7;7;7;7;7;7;7;7;7;7;7;7;7;7;7;0
0;1;1;1;1;1;1;1;1;1;1;1;1;1M;1;1;1;1;1;1;1;1;1;1;1;1;1;4;4;4;4;4;4;4;4;4;4;4;5;5;5;5;5M;5;5;5;5;5;5;5;5;7;7;7;7;7;3;7;7;7;7;7;7;7;7;7;7;7;7;0
0;1;1;1;1;1;1;1;1;1;1;1;1;1;1;1;1;1;1;1;1;1;1;1;1;1;1;1;4;4;4;4;4;4;4;4;4;4;4;5;5;5;5;5;5;5;5;5;5;5;7;7;7;7;7;3;3;3;7;7;7;7;7;7;7;7;7;7;7;0
0;1;1;1;1;1;1;1;1;1;1;1;1;1;1;1;1;1;1;1;1;1;1;1;1;1;1;1;4;4;4;4;4;4;4;4;4;4;4;4;5;5;5;5;5;5;5;5;5;7;7;7;7;7;3;3;3;3;3;7;7;7;7;7;7;7;7;7;7;0
0;1;1;1;1;1;1;1;1;1;1;1;1;1;1;1;1;1;1;1;1;1;1;1;1;1;1;4;4;4;4;4;4;4;4;4;4;4;4;4;4;5;5;5;5;5;5;5;7;7;7;7;7;3;3;3;3;3;3;3;7;7;7;7;7;7;7;7;7;0
0;1;1;1;1;1;1;1;1;1;1;1;1;1;1;1;1;1;1;1;1;1;1;1;1;1;4;4;4;4;4;4;4;4;4;4;4;4;4;4;4;4;5;5;5;5;5;7;7;7;7;7;3;3;3;3;3;3;3;3;3;7;7;7;7;7;7;7;7;0
0;8;1;1;1;1P;1;1;1;1;1;1;1;1;1;1;1;1;1;1;1;1;1;1;1;4;4;4;4;4;4;4;4;4;4;4;4;4;4;4;4;4;4;5;5;5;7;7;7;7;7;3;3;3;3;3;3;3;3;3;3;3;7;7;7;7;7;7;7;0
0;8;8;1;1;1;1;1;1;1;1;1;1;1M;1;1;1;1;1;1;1;1;1;1;4;4;4;4;4;4;4;4;4;4;4;4;4;4;4;4;4;4;4;4;5;7;7;7;7;7;3;3;3;3;3;3;3;3;3;3;3;3;3;7;7;7;7;7;7;0
0;8;8;8;1;1;1;1;1;1;1;1;1;1;1;1;1;1;1;1;1;1;1;4;4;4;4;4;4;4;4;4;4;4;4;4;4;4;4;4;4;4;4;4;4;7;7;7;7;3;3;3;3;3;3;3;3;3;3;3;3;3;3;3;7;7;7;7;7;0
0;8;8;8;8;1;1;1;1;1;1;1;1;1;1;1;1;1;1;1;1;1;4;4;4;4;4;4;4;4;4;4;4;4;4;4;4;4;4;4;4;4;4;4;4;4;7;7;3;3;3;3;3;3;3;3;3;3;3;3;3;3;3;3;3;7;7;7;7;0
0;8;8;8;8;8;1;1;1;1;1;1;1;1;1;1;1;1;1;1;1;4;4;4;4;4;4;4;4;4;4;4;4;4;4;4;4;4;4;4;4;4;4;4;4;4;7;3;3;3;3;3;3;3;3;3;3;3;3;3;3;3;3;3;3;3;7;7;7;0
0;8;8;8;8;8;8;1;1;1;1;1;1;1;1;1;1;1;1;1;4;4;4;4;4;4;4;4;4;4;4;4;4;4;4;4;4;4;4;4;4;4;4;4;4;0;3;3;3;3;3;3;3;3;3;3;3;3;3;3;3;3;3;3;3;3;3;7;7;0
0;8;8;8;8;8;8;8;1;1;1;1;1;1;1;1;1;1;1;4;4;4;4;4;4;4;4;4;4;4;4;4;4;4;4;4;4;4;4;4;4;4;4;4;0;3;3;3;3;3;3;3;3;3;3;3;3;3;3;3;3;3;3;3;3;3;3;3;7;0
0;8;8;8;8;8;8;8;8;1;1;1;1;1;1;1;1;1;4;4;4;4;4;4;4;4;4;4;4;4;4;4;4;4;4;4;4;4;4;4;4;4;4;0;3;3;3;3;3;3;3;3;3;3;3;3;3;3;3;3;3;3;3;3;3;3;3;3;3;0
0;8;8;8;8;8;8;8;8;8;1;1;1;1;1;1;1;0;0;4;4;4;4;4;4;4;4;4;4;4;4;4;4;4;4;4;4;4;4;4;4;4;0;3;3;3;3;3;3;3;3;3;3;3;3;3;3;3;3;3;3;3;3;3;3;3;3;3;3;0
0;8;8;8;8;8;8;8;8;8;8;1;1;1;1;1;0;0;0;0;4;4;4;4;4;4;4;4;4;4;4;4;4;4;4;4;4;4;4;4;4;0;3;3;3;3;3;3;3;3;3;3;3;3;3;3;3;3;3;3;3;3;3;3;3;3;3;3;3;0
0;8;8;8;8;8;8;8;8;8;8;8;1;1;1;8;8;0;0;0;0;4;4;4;4;4;4;4;4;4;4;4;4;4;4;4;4;4;4;4;0;0;3;3;3;3;3;3;3;3;3;3;3;3;3;3;3;3;3;3;3;3;3;3;3;3;3;3;3;0
0;8;8;8;8;8;8;8;8;8;8;8;1;1;1;8;8;8;0;0;0;0;4;4;4;4;4;4;4;4;4;4;4;4;4;4;4;4;4;0;0;0;0;3;3;3;3;3;3;3;3;3;3;3;3;3;3;3;3;3;3;3;3;3;3;3;3;3;3;0
0;8;8;8;8;8;8;8;8;8;8;8;8;1;8;8;8;8;8;0;0;0;4;4;4;4;4;4;4;4;4;4;4;4;4;4;4;4;4;0;0;0;0;0;3;3;3;3;3;3;3;3;3;3;3;3;3;3;3;3;3;3;3;3;3;3;3;3;3;0
0;8;8;8;8;8;8;8;8;8;8;8;8;8;8;8;8;8;8;8;0;0;0;4;4;4;4;4;4;4;4;4;4;4;4;4;4;4;0;0;0;0;0;9;9;3;3;3;3;3;3;3;3;3;3;3;3;3;3;3;3;3;3;3;3;3;3;3;9;0
0;8;8;8;8;8;8;8;8;8;8;8;8;8;8;8;8;8;8;8;8;0;0;0;4;4;4;4;4;4;4;4;4;4;4;4;4;0;0;0;0;0;9;9;9;9;3;3;3;3;3;3;3;3;3;3;3;3;3;3;3;3;3;3;3;3;3;9;9;0
0;8;8;8;8;8;8;8;8;8;8;8;8;8;8;8;8;8P;8;8;8;8;0;0;0;4;4;4;4;4;4;4M;4;4;4;4;0;0;0;0;0;9;9;9;9;9;9;3;3;3;3;3;3;3;3;3;3;3;3;3;3;3;3;3;3;3;9;9;9;0
0;8;8;8;8;8;8;8;8;8;8;8;8;8;8;8;8;8;8;8;8;8;8;0;0;0;4;4;4;4;4;4;4;4;4;0;0;0;0;0;9;9;9;9;9;9;9;9;3;3;3;3;3;3;3;3;3;3;3;3;3;3;3;3;3;9;9;9;9;0
0;8;8;8;8;8;8;8;8;8;8;8;8;8;8;8;8;8;8;8;8;8;8;8;0;0;0;4;4;4;4;4;4;4;0;0;0;0;0;9;9;9;9;9;9;9;9;9;9;3;3;3;3;3;3;3;3;3;3;3;3;3;3;3;9;9;9;9;9;0
0;8;8;8;8;8;8;8;8;8;8;8;8;8;8;8;8;8;8;8;8;8;8;8;8;0;0;0;4;4;4;4;4;0;0;0;0;0;9;9;9;9;9;9;9;9;9;9;9;9;3;3;3;3;3;3;3;3;3;3;3;3;3;9;9;9;9;9;9;0
0;8;8;8;8;8;8;8;8;8;8;8;8;8;8;8;8;8;8;8;8;8;8;8;8;0;0;0;0;4;4;4;0;0;0;0;0;9;9;9;9;9;9;9;9;9;9;9;9;9;9;3;3;3;3;3;3;3;3;3;3P;3;9;9M;9;9;9;9;9;0
0;8;8;8;8;8;8;8;8;8;8;8;8;8;8;8;8;8;8;8;8;8;8;8;0;0;0;0;0;0;4;0;0;0;0;0;9;9;9;9;9;9;9;9;9;9;9;9;9;9;9;3;3;3;3;3;3;3;3;3;3;3;9;9;9;9;9;9;9;0
0;8;8;8;8;8;8;8;8;8;8;8;8;8;8;8;8;8;8;8;8;8;8;0;0;0;0;0;0;0;0;0;0;0;0;9;9;9;9;9;9;9;9;9;9;9;9;9;9;9;9;9;3;3;3;3;3;3;3;3;3;9;9;9;9;9;9;9;9;0
0;8;8;8;8;8;8;8;8;8;8;8;8;8;8;8;8;8;8;8;8;8;8;0;0;0;0;0;0;0;0;0;0;0;9;9;9;9;9;9;9;9;9;9;9;9;9;9;9;9;9;9;9;3;3;3;3;3;3;3;9;9;9;9;9;9;9;9;9;0
0;8;8;8;8;8;8;8;8;8;8;8;8;8;8;8;8;8;8;8;8;8;0;0;0;0;0;0;0;0;0;0;0;9;9;9;9;9;9;9;9;9;9;9;9;9;9;9;9;9;9;9;9;9;3;3;3;3;3;9;9;9;9;9;9;9;9;9;9;0
0;8;8;8;8;8;8;8;8;8;8;8;8;8;8;8;8;8;8;8P;8;0;0;0;0;0;0;0;0;0;0;0;9;9;9;9;9;9;9;9;9;9;9;9;9;9;9;9;9;9;9;9;9;9;9;3;3;3;9;9;9;9;9;9;9;9;9;9;9;0
0;8;8;8;8;8;8;8;8;8;8;8;8;8;8;8;8;8;8;8;0;0;0;0;0;0;0;0;0;0;0;9;9;9;9;9;9;9;9;9;9;9;9;9;9;9;9;9;9;9;9;9;9;9;9;9;3P;9;9;9;9;9;9;9;9;9;9;9;9;0
0;8;8;8;8;8;8;8;8;8;8;8;8;8;8;8;8;8;8;0;0;0;0;0;0;0;0;0;0;0;9;9;9;9;9;9;9;9;9;9;9;9;9;9;9;9;9;9;9;9;9;9;9;9;9;9;9;9;9;9;9;9;9;9;9;9;9;9;9;0
0;8;8;8;8;8;8;8;8;8;8;8;8;8P;8;8;8;8;0;0;0;0;0;0;0;0;0;0;0;0;9;9;9;9;9;9;9;9;9;9;9;9;9;9;9;9;9;9;9;9;9;9;9;9;9;9;9;9;9;9;9;9;9;9;9;9;9;9;9;0
0;8;8;8;8;8;8;8;8;8;8;8;8;8;8;8;8;0;0;0;0;0;0;0;0;0;0;0;0;9;9;9;9;9;9;9;9;9;9;9;9;9;9;9;9;9;9;9;9;9;9;9;9;9;9;9;9;9;9;9;9;9;9;9;9;9;9;9;9;0
0;8;8;8;8;8;8;8;8;8;8;8;8;8;8;8;0;0;0;0;0;0;0;0;0;0;0;0;9;9;9;9;9;9;9;9;9;9;9;9;9;9;9;9;9;9;9;9;9;9;9;9;9;9;9;9;9;9;9;9;9;9;9;9;9;9;9;9;9;0
0;8;8;8;8;8;8;8;8;8;8;8;8;8;8;0;0;0;0;0;0;0;0;0;0;0;0;9;9;9;9;9;9;9;9;9;9;9;9;9;9;9;9;9;9;9;9;9;9;9;9;9;9;9;9;9;9;9;9;9;9;9;9;9;9;9;9;9;9;0
0;0;0;0;0;0;0;0;0;0;0;0;0;0;0;0;0;0;0;0;0;0;0;0;0;0;0;0;0;0;0;0;0;0;0;0;0;0;0;0;0;0;0;0;0;0;0;0;0;0;0;0;0;0;0;0;0;0;0;0;0;0;0;0;0;0;0;0;0;0
