32 32
4
6
9
4 2
0;0;0;0;0;0;0;0;0;0;0;0;0;0;0;0;0;0;0;0;0;0;0;0;0;0;0;0;0;0;0;0
0;1;2;3;4;5;5;5;5;5;5;4;4;3;2;1;0;1;2;2;3;4;4;4;4;4;4;4;3;2;1;0
0;2;3;4;4;5;5;6;6;5;5;4;4;3;2;1;0;1;1;2;3;3;4;4;4;4;4;3;3;2;1;0
0;2;3;4;4;5;5;6;6;5;5;5;4;3;2;2;1;0;1;1;2;2;3;3;3;4;3;3;3;2;1;0
0;2;3;4;4;5;5;5;5;5;5;5;4;3;3;2;1;1;0;1;1;2;2;2;3;3;3;3;2;2;1;0
0;2;3;3;4;4P;5;5;5;5;5;5;4;4;3;3;2;1;1;0;0;1;1;1;2;2P;2;2;2;1;0;0
0;2;2;3;3;4;4;4;5;5;5;4;4;4;3;3;3;2;2;1;1;1;0;0;1;1;1;1;1;0;0;0
0;1;2;2;3;3;3;4;4;4;4;4;4;4;4;3;3;3;3;2;2;2;1;1;0;0;0;0;0;0;1;0
0;1;1;1;2;2;2;3;3;3;3;3;4;4;4;4;4;3;3;3;3;3;2;2;1;1;1;1;1;1;2;0
0;0;0;0;1;1;1;2;2;2;3;3;3;3;4;4;4;4;4;4;4;3;3;3;2;2;2;2;2;2;2;0
0;1;1;1;0;0;0;1;1;1;2;2;3;3;3;4;4;4;4;5;4;4;4;4;3;3;3;3;3;3;3;0
0;2;2;2;1;1;1;1;0;0;1;1;2;3;3;4;4;5;5;5;5;5;5;5;4;4;4;4;4;4;4;0
0;3;3;3;2;2;2;2;1;1;0;1;1;2;3;4;4;5;5;5;6;6;6;5;5;5;5;5;4;4;5;0
0;4;4;3;3;3;3;2;2;1P;1;0;1;2;3;3;4;5;5;6;6;6;6;6;6;6;5;5;5;5;5;0
0;4;4;4;4;4;4;3;3;2;1;0;1;1;2;3;4;5;6;6;6;7;7;7;7;6;6;6;6;6;6;0
0;5;5;5;4;4;4;3;3;2;1;1;0;1;2;3;4;5;6;6;7;7;7M;7M;7M;7;7;6;6;6;6;0
0;5;5;5;5;4;4;4;3;2;2;1;0;1;2;3;4;5;6;6;7;7M;7M;7M;7M;7M;7M;7;7;6;6;0
0;5;5;5;5;4;4;3;3;2;1;1;0;1;2;3;4;5;6;6;7;7M;8M;8M;8M;7M;7M;7M;7;7;6;0
0;5;5;4;4;4;3;3;2;2;1;0;1;1;2;3;4;5;6;6;7;7M;8M;8M;8M;7M;7M;7M;7;6;6;0
0;4;4;4;3;3;3;2;2;1;1;0;1;2;3;3;4;5;6;6;7;7M;7M;7M;7M;7M;7M;7;7;6;6;0
0;4;3;3;3;2;2;1;1;0;0;1;1;2;3;4;4;5;6;6;7;7;7M;7M;7M;7M;7;7;6;6;6;0
0;3;2;2;2;1;1;0;0;0;1;2;2;3;3;4;4;5;6;6;6;7;7;7;7;7;6;6;6;5;5;0
0;2;1;1;1;0;0;1;1;1;2;2;3;3;4;4;5;5;5;6;6;6;6;6;6;6;6;5;5;5;4;0
0;1;1;0;0;1;1;2P;2;2;3;3;3;4;4;4;5;5;5;6;6;6;6;6;6;5;5;5;4;4;4;0
0;0;0;1;1;2;2;3;3;3;4;4;4;4;5;5;5;5;5;5;5;5;5;5;5;5;4;4;4;3;3;0
0;0;1;2;2;3;3;4;4;4;4;5;5;5;5;5;5;5;5;5;5;5;4;4;4;4;3;3;3;2;2;0
0;1;2;2;3;4;4;4;5;5;5;5;5;5;5;5;5;5;5;4;4;4;4;3;3;3;2;2;2;1;1;0
0;1;2;3;4;4;5;5;5;6;6;6;6;5;5;5;5;4;4;4;4;3;3;3;2;2;1;1;1;0;0;0
0;1;2;3;4;5;5;6;6;6;6;6;6;6;5;5;4;4;4;3;3;2;2;2;1;1;0;0;0;1;1;0
0;1;2;3;4;5;6;6;6;6;6;6;6;5;5;5;4;3;3;2;2;2;1;1;0;0;1;1;1;2;2;0
0;1;3;4;5;5;6;6;7;7;6;6;6;5;5;4;3;3;2;2;1;1;0;0;1;1;2;2;2;3;3;0
0;0;0;0;0;0;0;0;0;0;0;0;0;0;0;0;0;0;0;0;0;0;0;0;0;0;0;0;0;0;0;0
